111111111111111111111111111111111111111111111111111111111111111111111111111111111
10C00C000000000000000000000000000000000000000000000000000000000000000000000000001
100CP0C00000000000000000000000000000000000000000000000000000000000000000000000001
10C000E00000000000000000000000000000000000000000000000000000000000000000000000001
100000000000000000000000000000000000000000000000000000000000000000000000000000001
111111111111111111111111111111111111111111111111111111111111111111111111111111111