11111111
100C0001
1001P011
100100E1
11111111