11111111
100C0001
1001P111
100101E1
11111111