11111111
10C00001
1000P001
100000E1
11111111