111111111
10C00C001
100CP0C01
10C000111
1000001E1
111111111