1111111111111111111111111111111
1000000000000000000000000000001
1000000000001111111110000000001
1001111111000000000000011111001
1000000000001111111110000000001
100000000000000E00000000000P001
1000000000000000000000000000001
1111111111111111111111111111111