1111111111111111111111111111111
1000000000000000000000000000001
1000000000001111111110000000001
100111111100000E000000011111001
1000000000001111111110000000001
100000000000000C000000000000001
1000000000000000000000000000001
1111111111111111111111111111111